width 16
height 9
tile_width 80
tile_height 80
solid_tiles 
2, 3
layer1
0, 0, 0, 0, 0, 2, 0, 2, 0, 1, 0, 0, 0, 3, 0, 3
0, 0, 0, 0, 2, 3, 0, 0, 0, 1, 0, 0, 2, 3, 0, 2
0, 0, 0, 0, 0, 0, 0, 0, 3, 1, 0, 0, 3, 0, 0, 0
0, 0, 0, 0, 0, 0, 0, 0, 0, 1, 0, 0, 0, 0, 0, 0
3, 0, 0, 2, 0, 3, 3, 0, 0, 1, 0, 0, 0, 0, 0, 0
0, 0, 3, 2, 0, 0, 0, 0, 0, 1, 0, 2, 0, 2, 0, 0
0, 2, 0, 3, 0, 2, 0, 0, 0, 1, 0, 3, 0, 0, 0, 0
1, 1, 1, 1, 1, 1, 1, 1, 1, 1, 1, 1, 1, 1, 1, 1
0, 0, 0, 0, 0, 2, 2, 2, 0, 1, 0, 0, 0, 0, 0, 0
